11111111111111111111111111111111
11............................11
1..............2...............1
1..............................1
1..............................1
1.......11111......11111.......1
1.......1..............1.......1
1.......1...2..........1.......1
1.......1..............1.......1
1.......1..............1.......1
1..............................1
1..............11......2.......1
1..............11..............1
1..............................1
1.......1..............1.......1
1.......1.....2........1.......1
1.......1..............1.......1
1.......1..............1.......1
1.......11111......11111.......1
1..............................1
1..............................1
1..2...........................1
11............................11
11111111111111111111111111111111